0000000000
0........0
0..w.....0
0.asd....F
0........F
0....i...F
0....e...0
0.@......0
0........0
0000000000