0000000000
0........0
0.....C..0
B........0
B.@......F
B........F
0........0
0........0
0.....!..0
0000000000