0000000000
0........0
0.8.4.8..0
B........0
B.@......F
B........F
0........0
0........0
0........0
000NNN0000