000UUU0000
0........0
0........0
0........0
0........0
0........0
0...?....0
0........0
0........0
0000000000