1111111111
1....1...1
1....1...1
B....1...F
B.@......F
B........F
11111....1
1........1
1........1
1111DD1111