1111111111
1........1
1........1
B........F
B.@......F
B........F
1........1
1........1
1........1
1111DD1111