1111111111
1........1
1........1
B......FF1
B.@....FF1
B......FF1
1......FF1
1........1
1........1
1111111111