0000000000
0........0
0........0
B......FF0
B.@....FF0
B......FF0
0........0
0........0
0........0
0000000000