2222222222
2........2
2........2
2........F
2...@....F
2........F
2........2
2........2
2.L......2
2222222222