1111111111
1........1
1........1
1........F
1...@....F
1........F
1........1
1.....S..1
1........1
1111111111