2222222222
2........2
2.4...6..2
B........F
B.@......F
B........F
2........2
2.....5..2
2........2
2222NN2222