1111UU1111
11.1@...11
11.1..1..1
1....111.1
1.11.1...1
1.1..11111
1.111...11
1.1..11..1
1........1
1111111DD1