2222UU2222
2..2@.2..2
222......2
2....22..2
2.222...22
2...2.22.2
2..2...222
2.222....2
2..2..2..2
2222222DD2