2222222UU2
2.4....@.2
2........2
2........P
2........P
2.6......P
2......222
2......8.2
2........2
2222222222