1111UU1111
1...@....1
1........1
1........1
1........1
1....?...1
1........1
1........1
11......11
1111111111