2222222222
2........2
2........2
B......FF2
B.@....FF2
B......FF2
2......FF2
2........2
2........2
2222222222