2222222222
2.......22
2........2
B......222
B.@.....?2
B........2
2......222
2........2
2.......22
2222222222